G G G G G G G G G G G G G G G G G G G G G G G G G G G G G G
G G G G G G G G G G G G G G G G G G G G G G G G G G G G G G
G G G G G G G G G G G G G G G G G G B G G G G G G G G G G G
G G G G G G G G R R R R R R R R R R R R R R G G G G G G G G
G G G G G G G G R R R R R R R R R R R R R R G G G G G G G G
G G G G G G G G R R G G G G B G G G G G R R B G G G G G G G
G G G G G G G G R R G G G G G G G G G G R R R R R R R R R R
G G G G G G G B R R G G G G G G G G G G R R R R R R R R N R
R R R R R R R R R R G G G G G G G G G G G G G G G G G G R G
R R R R R R R R R R G G G G G G G G G G G G G G G G G G R G
G G G G R G G G G G G G G G G G G G G G G G G G G G G G G G
G G G G G G G G G G G G G G G G G G G G G G G G G G G G G G
G G G G G G G G G G G G G G G G G G G G G G G G G G G G G G
G G G G G G G G G G G G G G G G G G G G G G G G G G G G G G
G G G G G G G G G G G G G G G G G G G G G G G G G G G G G G
G G G G G G G G G G G G G G G G G G G G G G G G G G G G G G
G G G G G G G G G G G G G G G G G G G G G G G G G G G G G G
G G G G G G G G G G G G G G G G G G G G G G G G G G G G G G
G G G G G G G G G G G G G G G G G G G G G G G G G G G G G G
G G G G G G G G G G G G G G G G G G G G G G G G G G G G G G